10 10
####.###..
#.######.#
##.######.
###.###..#
##.####..#
#####..###
#.########
#.####.#.#
#####..##.
######.###
